1,1,1,1,1,1,1,1,1,1,1,1,1,1,1,1,
1,1,1,1,1,1,1,1,1,1,1,1,1,1,1,1,
1,6,2,2,4,3,3,6,2,2,4,3,3,6,2,2,
1,2,3,3,2,1,1,2,3,3,2,1,1,2,3,3,
1,2,1,1,2,1,1,2,1,1,2,1,1,2,1,1,
1,2,1,1,2,1,1,2,1,1,2,1,1,2,1,1,
1,2,1,1,2,1,1,2,1,1,2,1,1,2,1,1,
2,7,3,3,7,2,2,7,3,3,7,2,2,7,3,3,
1,1,1,1,1,1,1,1,1,1,1,1,1,1,1,1,
1,1,1,1,1,1,1,1,1,1,1,1,1,1,1,1,

